#######################################
# Syntax Coloring Map For Adafruit Bluefruit nRF52 Feather
#######################################

#######################################
# Datatypes (KEYWORD1)
#######################################

TimeoutTimer	KEYWORD1
Adafruit_FIFO	KEYWORD1
HardwarePWM	KEYWORD1

#######################################
# Core Function (KEYWORD2)
#######################################

digitalToggle	KEYWORD2
waitForEvent	KEYWORD2

enterSerialDfu	KEYWORD2
enterOTADfu	KEYWORD2
setLoopStacksize	KEYWORD2

ledOn	KEYWORD2
ledOff	KEYWORD2
ledToggle	KEYWORD2

printf	KEYWORD2
printBuffer	KEYWORD2

dwt_enable	KEYWORD2
dwt_disable	KEYWORD2
delay_ns	KEYWORD2

# RTOS
rtos_malloc	KEYWORD2
rtos_free	KEYWORD2
rtos_realloc	KEYWORD2

nrf52_flash_init	KEYWORD2
nrf52_flash_erase_sector	KEYWORD2
nrf52_flash_write	KEYWORD2

VERIFY_STATIC	KEYWORD2
VERIFY_STATUS	KEYWORD2
VERIFY	KEYWORD2

dbgHeapTotal	KEYWORD2
dbgHeapUsed	KEYWORD2
dbgHeapFree	KEYWORD2
dbgMemInfo	KEYWORD2
dbgPrintVersion	KEYWORD2

startLoop	KEYWORD2

#######################################
# Adafruit_FIFO Methods (KEYWORD2)
#######################################

clear	KEYWORD2
peek	KEYWORD2
peekAt	KEYWORD2
empty	KEYWORD2
full	KEYWORD2
count	KEYWORD2
remaining	KEYWORD2

#######################################
# TimeoutTimer Methods (KEYWORD2)
#######################################

set	KEYWORD2
expired	KEYWORD2
restart	KEYWORD2
reset	KEYWORD2

#######################################
# HardwarePWM Methods (KEYWORD2)
#######################################

setResolution	KEYWORD2
setClockDiv	KEYWORD2
addPin	KEYWORD2
pin2channel	KEYWORD2

checkPin	KEYWORD2

enabled	KEYWORD2
writePin	KEYWORD2
writeChannel	KEYWORD2

#######################################
# Constants (LITERAL1)
#######################################
INPUT_PULLDOWN	LITERAL1

PIN_A0	LITERAL1
PIN_A1	LITERAL1
PIN_A2	LITERAL1
PIN_A3	LITERAL1
PIN_A4	LITERAL1
PIN_A5	LITERAL1
PIN_A6	LITERAL1
PIN_A7	LITERAL1

PIN_AREF	LITERAL1
PIN_DFU	LITERAL1
PIN_NFC1	LITERAL1
PIN_NFC2	LITERAL1

PIN_SERIAL_RX	LITERAL1
PIN_SERIAL_TX	LITERAL1

PIN_SPI_MISO	LITERAL1
PIN_SPI_MOSI	LITERAL1
PIN_SPI_SCK	LITERAL1

PIN_WIRE_SDA	LITERAL1
PIN_WIRE_SCL	LITERAL1

